Sequence,ETS1_NUV_r1,ETS1_NUV_r2,ETS1_UV_r1,ETS1_UV_r2,UVDDB,UVDDB_ETS1,Competition_Effect,Effect_Group_by_Range,Effect_Group_by_JNB
CACATACACCGGAAGTGCACATACA,26853,26413,3073,1470,24858,28583,-3725,0,0
CACATACACCGGAAGTGCACATACA,38436,21835,3379,2308,26734,28692,-1958,0,0
CACATACACCGGAAGTGCACATACA,17005,15432,2539,2134,24644,18038,6606,0,1
CACATACACCGGAAGTGCACATACA,28020,35610,2927,1954,24003,22722,1281,0,0
CACATACACCGGAAGTGCACATACA,32444,20453,4244,3374,30212,26717,3495,0,0
CACATACACCGGAAGTGCACATACA,26917,24927,2681,2158,32924,21200,11724,1,1
CACATACACCGGAAGTGCACATACA,26148,23663,2367,1588,22283,13674,8609,1,1
CACATACACCGGAAGTGCACATACA,21128,17696,4613,3046,30358,20217,10141,1,1
CACATACACCGGAAGTGCACATACA,48810,21026,4439,2718,34254,25626,8628,1,1
CACATACACCGGAAGTGCACATACA,27696,26972,3090,2514,32105,17473,14632,1,2
CACATACCCCGGAAGTGCACATACA,19152,12027,934,1005,40131,32301,7830,1,1
CACATACCCCGGAAGTGCACATACA,11805,13337,1119,381,34602,19436,15166,1,2
CACATACCCCGGAAGTGCACATACA,10917,7429,1147,1006,37848,30518,7330,1,1
CACATACCCCGGAAGTGCACATACA,9232,7264,971,781,31557,21421,10136,1,1
CACATACCCCGGAAGTGCACATACA,15173,15209,1094,500,33252,21002,12250,1,1
CACATACCCCGGAAGTGCACATACA,17502,14146,674,596,32115,28383,3732,0,0
CACATACCCCGGAAGTGCACATACA,7894,6513,1344,997,39333,20462,18871,2,2
CACATACCCCGGAAGTGCACATACA,6700,7156,1460,1030,31374,15597,15777,2,2
CACATACCCCGGAAGTGCACATACA,11427,9583,967,515,42988,23147,19841,2,2
CACATACCCCGGAAGTGCACATACA,12175,9116,905,636,42117,24708,17409,2,2
CACATACGCCGGAAGTGCACATACA,19645,12698,3101,2128,36427,24693,11734,1,1
CACATACGCCGGAAGTGCACATACA,15845,21259,3945,2600,37156,20801,16355,2,2
CACATACGCCGGAAGTGCACATACA,16350,17493,2876,1928,27252,18430,8822,1,1
CACATACGCCGGAAGTGCACATACA,26355,9705,2717,1609,39968,25508,14460,1,2
CACATACGCCGGAAGTGCACATACA,14066,12506,2705,1965,28592,18596,9996,1,1
CACATACGCCGGAAGTGCACATACA,18391,12933,2928,2699,30374,28045,2329,0,0
CACATACGCCGGAAGTGCACATACA,26935,16059,3028,1961,25251,21652,3599,0,0
CACATACGCCGGAAGTGCACATACA,19836,20150,3045,1526,26092,17306,8786,1,1
CACATACGCCGGAAGTGCACATACA,13863,14882,3359,2766,39398,21614,17784,2,2
CACATACGCCGGAAGTGCACATACA,21854,14029,3843,1142,26024,24299,1725,0,0
CACATACTCCGGAAGTGCACATACA,10163,13072,820,493,47197,20489,26708,2,2
CACATACTCCGGAAGTGCACATACA,4978,7823,414,379,43647,27279,16368,2,2
CACATACTCCGGAAGTGCACATACA,15025,8248,580,227,39164,31969,7195,1,1
CACATACTCCGGAAGTGCACATACA,16921,8544,777,203,35538,29126,6412,0,1
CACATACTCCGGAAGTGCACATACA,10878,11535,494,357,41535,28301,13234,1,2
CACATACTCCGGAAGTGCACATACA,11700,14205,574,274,29033,30555,-1522,0,0
CACATACTCCGGAAGTGCACATACA,15634,14466,490,396,35331,20798,14533,1,2
CACATACTCCGGAAGTGCACATACA,16934,10115,874,345,36374,34630,1744,0,0
CACATACTCCGGAAGTGCACATACA,18231,13725,812,442,40006,35346,4660,0,0
CACATACTCCGGAAGTGCACATACA,13731,11356,514,360,35872,31859,4013,0,0
CACATACACCGGAAGTACACATACA,37658,20072,3756,2286,39774,31512,8262,1,1
CACATACACCGGAAGTACACATACA,23680,20980,4703,2658,44862,20560,24302,2,2
CACATACACCGGAAGTACACATACA,31826,29117,2655,1673,22643,18757,3886,0,0
CACATACACCGGAAGTACACATACA,21092,26015,3464,1593,24714,18921,5793,0,1
CACATACACCGGAAGTACACATACA,20628,20460,4019,2610,44035,25038,18997,2,2
CACATACACCGGAAGTACACATACA,16954,13887,4522,2959,32568,19221,13347,1,2
CACATACACCGGAAGTACACATACA,19627,17579,4469,3151,41268,22806,18462,2,2
CACATACACCGGAAGTACACATACA,31804,28392,2302,1825,27656,21290,6366,0,1
CACATACACCGGAAGTACACATACA,27016,19908,2396,1708,27143,26629,514,0,0
CACATACACCGGAAGTACACATACA,26450,25089,2027,1049,28146,17062,11084,1,1
CACATACACCGGAAGTCCACATACA,47414,15232,3479,2613,37186,31598,5588,0,0
CACATACACCGGAAGTCCACATACA,30522,19871,2996,1520,35416,34468,948,0,0
CACATACACCGGAAGTCCACATACA,60837,19220,4234,2331,42971,31417,11554,1,1
CACATACACCGGAAGTCCACATACA,23173,16526,2806,1699,31082,25759,5323,0,0
CACATACACCGGAAGTCCACATACA,35369,25034,3280,1938,31490,28704,2786,0,0
CACATACACCGGAAGTCCACATACA,24593,17646,3264,2479,47891,26792,21099,2,2
CACATACACCGGAAGTCCACATACA,38008,25635,4142,2350,39183,26525,12658,1,2
CACATACACCGGAAGTCCACATACA,24082,21793,1833,1719,31288,18378,12910,1,2
CACATACACCGGAAGTCCACATACA,18197,18568,5685,2162,42350,20314,22036,2,2
CACATACACCGGAAGTCCACATACA,17096,14228,3116,2958,34398,24850,9548,1,1
CACATACACCGGAAGTTCACATACA,34304,22987,2979,3400,44872,27088,17784,2,2
CACATACACCGGAAGTTCACATACA,24467,18641,5568,3352,48874,26160,22714,2,2
CACATACACCGGAAGTTCACATACA,24729,15222,3506,3359,38364,28581,9783,1,1
CACATACACCGGAAGTTCACATACA,10566,16701,4416,4154,46829,24569,22260,2,2
CACATACACCGGAAGTTCACATACA,24665,21311,5629,3089,36298,23528,12770,1,2
CACATACACCGGAAGTTCACATACA,28175,18642,3792,4226,43291,35377,7914,1,1
CACATACACCGGAAGTTCACATACA,21171,22899,3430,2044,38742,27883,10859,1,1
CACATACACCGGAAGTTCACATACA,33251,21283,2275,2369,36311,29674,6637,0,1
CACATACACCGGAAGTTCACATACA,14814,16499,4104,3525,41630,33005,8625,1,1
CACATACACCGGAAGTTCACATACA,25013,26571,3508,2446,49692,23312,26380,2,2
CACATACAACGGAAGTGCACATACA,5579,5811,1342,757,31283,21513,9770,1,1
CACATACAACGGAAGTGCACATACA,6491,6257,1327,653,34673,18229,16444,2,2
CACATACAACGGAAGTGCACATACA,5648,7326,1252,863,36264,20168,16096,2,2
CACATACAACGGAAGTGCACATACA,6844,7734,1489,999,25998,16431,9567,1,1
CACATACAACGGAAGTGCACATACA,5460,5154,1042,592,29656,19501,10155,1,1
CACATACAACGGAAGTGCACATACA,3789,4161,1227,808,29396,15127,14269,1,2
CACATACAACGGAAGTGCACATACA,5313,3913,1417,678,31076,25218,5858,0,1
CACATACAACGGAAGTGCACATACA,6526,4045,971,720,23976,26734,-2758,0,0
CACATACAACGGAAGTGCACATACA,3888,4766,973,572,38606,16767,21839,2,2
CACATACAACGGAAGTGCACATACA,5569,4566,1141,839,42100,20725,21375,2,2
CACATACAGCGGAAGTGCACATACA,7494,8051,1100,854,29776,15841,13935,1,2
CACATACAGCGGAAGTGCACATACA,5810,7237,2404,1886,44179,19820,24359,2,2
CACATACAGCGGAAGTGCACATACA,16639,8106,1802,1410,34903,31703,3200,0,0
CACATACAGCGGAAGTGCACATACA,8271,7534,2125,1399,32965,20911,12054,1,1
CACATACAGCGGAAGTGCACATACA,11727,10530,1264,815,28366,21761,6605,0,1
CACATACAGCGGAAGTGCACATACA,13371,8241,1602,1469,30889,25444,5445,0,0
CACATACAGCGGAAGTGCACATACA,8856,4520,1410,1129,27059,19866,7193,1,1
CACATACAGCGGAAGTGCACATACA,7292,10504,1821,1012,34253,17859,16394,2,2
CACATACAGCGGAAGTGCACATACA,4796,5278,2177,1557,41467,20766,20701,2,2
CACATACAGCGGAAGTGCACATACA,8806,9923,1502,1380,33307,16499,16808,2,2
CACATACATCGGAAGTGCACATACA,1549,1412,249,48,29026,17531,11495,1,1
CACATACATCGGAAGTGCACATACA,2235,2716,388,172,24965,16792,8173,1,1
CACATACATCGGAAGTGCACATACA,2016,1640,79,129,27349,20987,6362,0,1
CACATACATCGGAAGTGCACATACA,1634,1331,376,139,24927,17154,7773,1,1
CACATACATCGGAAGTGCACATACA,1442,1423,138,166,41236,20294,20942,2,2
CACATACATCGGAAGTGCACATACA,2151,2127,215,102,33666,18360,15306,1,2
CACATACATCGGAAGTGCACATACA,1728,1192,271,78,31166,15632,15534,1,2
CACATACATCGGAAGTGCACATACA,1832,1657,368,142,42215,18644,23571,2,2
CACATACATCGGAAGTGCACATACA,2284,1394,154,101,26684,19694,6990,1,1
CACATACATCGGAAGTGCACATACA,1683,1492,193,219,35051,18949,16102,2,2
CACATACACAGGAAGTGCACATACA,5238,7321,1754,990,26404,17796,8608,1,1
CACATACACAGGAAGTGCACATACA,6831,2806,1782,1741,25945,12931,13014,1,2
CACATACACAGGAAGTGCACATACA,7290,8610,2700,1534,29716,15695,14021,1,2
CACATACACAGGAAGTGCACATACA,5004,6838,2758,2331,41244,25646,15598,2,2
CACATACACAGGAAGTGCACATACA,12684,6024,2380,1733,33844,27724,6120,0,1
CACATACACAGGAAGTGCACATACA,8151,8368,2889,1766,33322,15838,17484,2,2
CACATACACAGGAAGTGCACATACA,7279,5674,1975,1683,31411,25162,6249,0,1
CACATACACAGGAAGTGCACATACA,8502,10287,1843,1500,31118,16212,14906,1,2
CACATACACAGGAAGTGCACATACA,6152,7103,3175,1646,34030,18221,15809,2,2
CACATACACAGGAAGTGCACATACA,6769,4959,1719,1187,23396,15686,7710,1,1
CACATACACGGGAAGTGCACATACA,1425,1057,480,500,25543,16215,9328,1,1
CACATACACGGGAAGTGCACATACA,2000,1466,593,724,29374,25181,4193,0,0
CACATACACGGGAAGTGCACATACA,3065,1909,759,571,20584,19970,614,0,0
CACATACACGGGAAGTGCACATACA,2145,1790,606,551,28352,19584,8768,1,1
CACATACACGGGAAGTGCACATACA,1930,1507,772,648,22813,17885,4928,0,0
CACATACACGGGAAGTGCACATACA,1860,1264,592,1028,28891,17739,11152,1,1
CACATACACGGGAAGTGCACATACA,1419,1371,732,589,22720,15795,6925,1,1
CACATACACGGGAAGTGCACATACA,1894,1493,789,701,28445,15233,13212,1,2
CACATACACGGGAAGTGCACATACA,2017,1694,407,442,29758,17279,12479,1,2
CACATACACGGGAAGTGCACATACA,2965,1062,668,478,26155,25589,566,0,0
CACATACACTGGAAGTGCACATACA,243,211,205,91,26443,18233,8210,1,1
CACATACACTGGAAGTGCACATACA,106,62,157,31,19755,13303,6452,0,1
CACATACACTGGAAGTGCACATACA,271,273,179,53,65535,18843,46692,2,2
CACATACACTGGAAGTGCACATACA,184,122,102,198,30145,17167,12978,1,2
CACATACACTGGAAGTGCACATACA,367,78,60,70,38847,18060,20787,2,2
CACATACACTGGAAGTGCACATACA,207,103,117,32,32493,17761,14732,1,2
CACATACACTGGAAGTGCACATACA,372,147,152,235,27440,21929,5511,0,0
CACATACACTGGAAGTGCACATACA,353,139,109,146,29191,29218,-27,0,0
CACATACACTGGAAGTGCACATACA,181,65,77,92,33134,25177,7957,1,1
CACATACACTGGAAGTGCACATACA,114,63,139,62,31743,15725,16018,2,2
CACATACACCAGAAGTGCACATACA,31,27,112,48,29886,15769,14117,1,2
CACATACACCAGAAGTGCACATACA,27,27,240,106,27474,19211,8263,1,1
CACATACACCAGAAGTGCACATACA,93,75,152,63,21467,12189,9278,1,1
CACATACACCAGAAGTGCACATACA,99,250,158,114,28783,14800,13983,1,2
CACATACACCAGAAGTGCACATACA,352,397,157,67,31714,16486,15228,1,2
CACATACACCAGAAGTGCACATACA,53,25,85,40,33615,18700,14915,1,2
CACATACACCAGAAGTGCACATACA,125,38,277,37,20259,13275,6984,1,1
CACATACACCAGAAGTGCACATACA,58,31,104,56,30725,15378,15347,1,2
CACATACACCAGAAGTGCACATACA,72,27,173,165,28473,17677,10796,1,1
CACATACACCAGAAGTGCACATACA,32,27,31,59,29300,25902,3398,0,0
CACATACACCCGAAGTGCACATACA,77,27,199,34,31178,13578,17600,2,2
CACATACACCCGAAGTGCACATACA,83,33,350,61,23849,15791,8058,1,1
CACATACACCCGAAGTGCACATACA,32,28,175,180,24138,15452,8686,1,1
CACATACACCCGAAGTGCACATACA,33,39,118,74,33566,23716,9850,1,1
CACATACACCCGAAGTGCACATACA,136,44,317,114,22581,15688,6893,1,1
CACATACACCCGAAGTGCACATACA,32,23,315,33,25155,15674,9481,1,1
CACATACACCCGAAGTGCACATACA,30,27,159,101,35149,18670,16479,2,2
CACATACACCCGAAGTGCACATACA,75,25,104,65,22082,16064,6018,0,1
CACATACACCCGAAGTGCACATACA,28,27,140,65,22233,13270,8963,1,1
CACATACACCCGAAGTGCACATACA,85,25,74,51,21877,15254,6623,0,1
CACATACACCTGAAGTGCACATACA,79,26,80,66,29596,21284,8312,1,1
CACATACACCTGAAGTGCACATACA,39,70,61,34,36063,28769,7294,1,1
CACATACACCTGAAGTGCACATACA,156,28,116,93,23978,21595,2383,0,0
CACATACACCTGAAGTGCACATACA,46,26,69,31,23956,17901,6055,0,1
CACATACACCTGAAGTGCACATACA,63,28,100,70,40674,19681,20993,2,2
CACATACACCTGAAGTGCACATACA,29,28,136,52,37632,19203,18429,2,2
CACATACACCTGAAGTGCACATACA,25,32,135,31,27563,17105,10458,1,1
CACATACACCTGAAGTGCACATACA,29,24,27,98,27311,19117,8194,1,1
CACATACACCTGAAGTGCACATACA,58,43,68,29,30524,18647,11877,1,1
CACATACACCTGAAGTGCACATACA,31,39,235,80,28620,23039,5581,0,0
CACATACACCGAAAGTGCACATACA,29,44,115,171,25089,14060,11029,1,1
CACATACACCGAAAGTGCACATACA,28,25,72,197,16648,12500,4148,0,0
CACATACACCGAAAGTGCACATACA,44,27,126,29,22140,16596,5544,0,0
CACATACACCGAAAGTGCACATACA,30,28,77,34,21555,21493,62,0,0
CACATACACCGAAAGTGCACATACA,268,26,117,118,19344,13797,5547,0,0
CACATACACCGAAAGTGCACATACA,29,80,155,29,15528,10353,5175,0,0
CACATACACCGAAAGTGCACATACA,152,29,183,271,17572,18475,-903,0,0
CACATACACCGAAAGTGCACATACA,54,35,64,33,21310,18209,3101,0,0
CACATACACCGAAAGTGCACATACA,40,145,56,63,21642,12583,9059,1,1
CACATACACCGAAAGTGCACATACA,40,23,181,71,19571,11969,7602,1,1
CACATACACCGCAAGTGCACATACA,266,87,106,53,23487,16732,6755,0,1
CACATACACCGCAAGTGCACATACA,26,63,163,44,21905,13052,8853,1,1
CACATACACCGCAAGTGCACATACA,41,26,138,175,17985,17062,923,0,0
CACATACACCGCAAGTGCACATACA,30,27,834,94,18721,13444,5277,0,0
CACATACACCGCAAGTGCACATACA,71,34,36,133,23525,12192,11333,1,1
CACATACACCGCAAGTGCACATACA,41,23,110,32,21697,12690,9007,1,1
CACATACACCGCAAGTGCACATACA,127,26,187,138,25360,14054,11306,1,1
CACATACACCGCAAGTGCACATACA,130,93,99,96,21452,13802,7650,1,1
CACATACACCGCAAGTGCACATACA,30,27,279,168,27828,14920,12908,1,2
CACATACACCGCAAGTGCACATACA,48,25,59,58,25953,19162,6791,0,1
CACATACACCGTAAGTGCACATACA,32,42,154,39,16740,19916,-3176,0,0
CACATACACCGTAAGTGCACATACA,34,34,70,77,38829,20000,18829,2,2
CACATACACCGTAAGTGCACATACA,47,61,178,50,32377,25683,6694,0,1
CACATACACCGTAAGTGCACATACA,53,25,160,81,26142,24174,1968,0,0
CACATACACCGTAAGTGCACATACA,30,27,35,147,26505,18968,7537,1,1
CACATACACCGTAAGTGCACATACA,73,25,70,85,29434,26618,2816,0,0
CACATACACCGTAAGTGCACATACA,96,31,62,78,30595,24549,6046,0,1
CACATACACCGTAAGTGCACATACA,75,26,49,55,25784,20164,5620,0,0
CACATACACCGTAAGTGCACATACA,59,29,158,32,35877,20851,15026,1,2
CACATACACCGTAAGTGCACATACA,63,27,110,56,24607,17298,7309,1,1
CACATACACCGGCAGTGCACATACA,226,61,158,100,18581,13795,4786,0,0
CACATACACCGGCAGTGCACATACA,80,53,248,222,15865,13067,2798,0,0
CACATACACCGGCAGTGCACATACA,92,70,161,32,13698,11457,2241,0,0
CACATACACCGGCAGTGCACATACA,52,26,102,83,13812,9515,4297,0,0
CACATACACCGGCAGTGCACATACA,406,183,177,154,20483,14136,6347,0,1
CACATACACCGGCAGTGCACATACA,209,438,260,72,15615,8168,7447,1,1
CACATACACCGGCAGTGCACATACA,131,90,122,114,19224,17567,1657,0,0
CACATACACCGGCAGTGCACATACA,166,185,157,129,18645,13136,5509,0,0
CACATACACCGGCAGTGCACATACA,158,63,115,254,16267,9974,6293,0,1
CACATACACCGGCAGTGCACATACA,84,99,276,71,21379,11230,10149,1,1
CACATACACCGGGAGTGCACATACA,43,63,182,29,29356,20445,8911,1,1
CACATACACCGGGAGTGCACATACA,139,72,48,220,24363,16480,7883,1,1
CACATACACCGGGAGTGCACATACA,94,69,65,73,33257,18711,14546,1,2
CACATACACCGGGAGTGCACATACA,83,90,140,79,35982,18412,17570,2,2
CACATACACCGGGAGTGCACATACA,95,98,76,51,25537,17155,8382,1,1
CACATACACCGGGAGTGCACATACA,347,328,412,29,39787,19118,20669,2,2
CACATACACCGGGAGTGCACATACA,127,190,244,241,37567,19761,17806,2,2
CACATACACCGGGAGTGCACATACA,137,94,83,39,31151,29034,2117,0,0
CACATACACCGGGAGTGCACATACA,119,96,173,202,39962,20520,19442,2,2
CACATACACCGGGAGTGCACATACA,52,113,268,49,22067,20087,1980,0,0
CACATACACCGGTAGTGCACATACA,824,430,476,511,23382,18799,4583,0,0
CACATACACCGGTAGTGCACATACA,486,394,692,259,20368,11575,8793,1,1
CACATACACCGGTAGTGCACATACA,520,514,561,380,17171,11707,5464,0,0
CACATACACCGGTAGTGCACATACA,696,454,587,697,19986,12490,7496,1,1
CACATACACCGGTAGTGCACATACA,752,497,381,340,19812,17453,2359,0,0
CACATACACCGGTAGTGCACATACA,717,392,695,489,15774,16160,-386,0,0
CACATACACCGGTAGTGCACATACA,1213,479,546,527,16790,16872,-82,0,0
CACATACACCGGTAGTGCACATACA,1164,480,715,414,22662,12977,9685,1,1
CACATACACCGGTAGTGCACATACA,537,378,602,380,17337,10598,6739,0,1
CACATACACCGGTAGTGCACATACA,550,514,471,352,19288,13353,5935,0,1
CACATACACCGGACGTGCACATACA,3843,4723,6251,4208,21740,14267,7473,1,1
CACATACACCGGACGTGCACATACA,3752,2622,4286,3954,23185,16099,7086,1,1
CACATACACCGGACGTGCACATACA,4806,5221,6502,3831,21872,14139,7733,1,1
CACATACACCGGACGTGCACATACA,3819,2869,6029,3606,22433,22150,283,0,0
CACATACACCGGACGTGCACATACA,6575,4050,6050,3266,18785,15593,3192,0,0
CACATACACCGGACGTGCACATACA,7071,4191,4318,4780,23904,24316,-412,0,0
CACATACACCGGACGTGCACATACA,3489,3496,7691,5613,32456,17295,15161,1,2
CACATACACCGGACGTGCACATACA,3697,2301,4862,4838,30068,18083,11985,1,1
CACATACACCGGACGTGCACATACA,3847,4511,6641,4653,29294,13739,15555,1,2
CACATACACCGGACGTGCACATACA,3535,3213,6496,3007,25570,19072,6498,0,1
CACATACACCGGAGGTGCACATACA,669,311,194,63,20563,14479,6084,0,1
CACATACACCGGAGGTGCACATACA,784,348,230,153,21612,19417,2195,0,0
CACATACACCGGAGGTGCACATACA,725,560,183,236,22727,20653,2074,0,0
CACATACACCGGAGGTGCACATACA,516,581,194,263,28200,15568,12632,1,2
CACATACACCGGAGGTGCACATACA,633,422,119,69,25531,14036,11495,1,1
CACATACACCGGAGGTGCACATACA,807,548,190,65,25197,15789,9408,1,1
CACATACACCGGAGGTGCACATACA,490,442,211,85,27437,14039,13398,1,2
CACATACACCGGAGGTGCACATACA,500,377,248,329,24507,14837,9670,1,1
CACATACACCGGAGGTGCACATACA,975,387,293,399,22316,23367,-1051,0,0
CACATACACCGGAGGTGCACATACA,607,702,144,94,21874,13119,8755,1,1
CACATACACCGGATGTGCACATACA,13862,11801,10202,9156,24410,16523,7887,1,1
CACATACACCGGATGTGCACATACA,15752,11485,5869,5965,23347,20187,3160,0,0
CACATACACCGGATGTGCACATACA,17229,14088,10223,11184,28099,17754,10345,1,1
CACATACACCGGATGTGCACATACA,23204,19625,10822,7394,23258,19611,3647,0,0
CACATACACCGGATGTGCACATACA,23560,15361,12954,9541,35683,28843,6840,1,1
CACATACACCGGATGTGCACATACA,15677,13420,12222,10292,34981,19654,15327,1,2
CACATACACCGGATGTGCACATACA,12506,13940,15519,10204,36509,17861,18648,2,2
CACATACACCGGATGTGCACATACA,19969,21270,10770,6497,28581,15816,12765,1,2
CACATACACCGGATGTGCACATACA,23341,14246,11034,11827,24665,18170,6495,0,1
CACATACACCGGATGTGCACATACA,12977,9111,17570,10445,34823,16513,18310,2,2
CACATACACCGGAAATGCACATACA,28390,24721,2323,1814,26732,14543,12189,1,1
CACATACACCGGAAATGCACATACA,21230,24064,1670,1404,18797,11931,6866,1,1
CACATACACCGGAAATGCACATACA,17838,15219,3708,2706,33224,16990,16234,2,2
CACATACACCGGAAATGCACATACA,12671,12814,2078,1366,17711,13086,4625,0,0
CACATACACCGGAAATGCACATACA,24970,18285,3711,2379,23179,14855,8324,1,1
CACATACACCGGAAATGCACATACA,21665,15808,2631,1612,20477,18320,2157,0,0
CACATACACCGGAAATGCACATACA,19522,22385,3139,1425,22536,13615,8921,1,1
CACATACACCGGAAATGCACATACA,27943,13704,3507,2410,23725,13761,9964,1,1
CACATACACCGGAAATGCACATACA,20486,16608,1732,1665,18630,12671,5959,0,1
CACATACACCGGAAATGCACATACA,20506,16204,3250,2308,32323,19026,13297,1,2
CACATACACCGGAACTGCACATACA,5271,3038,1855,1247,33957,29960,3997,0,0
CACATACACCGGAACTGCACATACA,5932,2727,1764,1127,34295,28296,5999,0,1
CACATACACCGGAACTGCACATACA,3764,3711,1368,912,35054,21045,14009,1,2
CACATACACCGGAACTGCACATACA,4764,2456,1324,965,30107,22018,8089,1,1
CACATACACCGGAACTGCACATACA,3338,2350,1642,1921,32141,19853,12288,1,1
CACATACACCGGAACTGCACATACA,4184,4499,1659,1148,36289,19168,17121,2,2
CACATACACCGGAACTGCACATACA,4270,4390,1637,805,29915,19838,10077,1,1
CACATACACCGGAACTGCACATACA,4196,4722,1486,1279,26499,18206,8293,1,1
CACATACACCGGAACTGCACATACA,4414,3540,1985,1362,30672,18194,12478,1,2
CACATACACCGGAACTGCACATACA,3613,3606,1038,541,27829,15488,12341,1,1
CACATACACCGGAATTGCACATACA,1410,1463,250,161,27473,20068,7405,1,1
CACATACACCGGAATTGCACATACA,1390,993,409,349,37047,22730,14317,1,2
CACATACACCGGAATTGCACATACA,1325,1275,328,233,19622,13446,6176,0,1
CACATACACCGGAATTGCACATACA,1371,837,324,100,22937,13967,8970,1,1
CACATACACCGGAATTGCACATACA,1051,1276,525,226,37860,19200,18660,2,2
CACATACACCGGAATTGCACATACA,1481,1503,220,351,26414,18664,7750,1,1
CACATACACCGGAATTGCACATACA,1533,711,444,308,23801,16690,7111,1,1
CACATACACCGGAATTGCACATACA,2062,1219,627,221,30158,28894,1264,0,0
CACATACACCGGAATTGCACATACA,1285,881,455,434,30320,24553,5767,0,1
CACATACACCGGAATTGCACATACA,1846,1158,535,242,29574,24170,5404,0,0
CACATACACCGGAAGAGCACATACA,4441,4461,817,442,28019,16938,11081,1,1
CACATACACCGGAAGAGCACATACA,5543,6643,419,289,16679,10153,6526,0,1
CACATACACCGGAAGAGCACATACA,6341,5177,573,367,20186,15715,4471,0,0
CACATACACCGGAAGAGCACATACA,8688,6127,442,253,23262,18511,4751,0,0
CACATACACCGGAAGAGCACATACA,8704,4821,542,159,22806,17344,5462,0,0
CACATACACCGGAAGAGCACATACA,6990,3716,632,216,18468,11045,7423,1,1
CACATACACCGGAAGAGCACATACA,11158,6862,644,279,24587,17166,7421,1,1
CACATACACCGGAAGAGCACATACA,6751,4958,351,345,20252,19062,1190,0,0
CACATACACCGGAAGAGCACATACA,7775,4394,685,398,28219,13461,14758,1,2
CACATACACCGGAAGAGCACATACA,8377,9131,569,416,16109,10901,5208,0,0
CACATACACCGGAAGCGCACATACA,17456,18338,2557,1245,33908,19167,14741,1,2
CACATACACCGGAAGCGCACATACA,14822,16304,2192,916,25595,24917,678,0,0
CACATACACCGGAAGCGCACATACA,8397,9570,3064,2385,33944,17568,16376,2,2
CACATACACCGGAAGCGCACATACA,24967,16472,2564,1351,34466,24007,10459,1,1
CACATACACCGGAAGCGCACATACA,9813,6952,1962,1068,26634,13963,12671,1,2
CACATACACCGGAAGCGCACATACA,13033,8853,2759,1866,36306,21099,15207,1,2
CACATACACCGGAAGCGCACATACA,19438,11955,2927,2285,41398,22188,19210,2,2
CACATACACCGGAAGCGCACATACA,12405,14385,2076,1066,23714,17725,5989,0,1
CACATACACCGGAAGCGCACATACA,13143,9362,1935,1501,30162,16790,13372,1,2
CACATACACCGGAAGCGCACATACA,14429,13469,1934,1489,30516,26083,4433,0,0
CACATACACCGGAAGGGCACATACA,7939,7043,599,367,24000,18877,5123,0,0
CACATACACCGGAAGGGCACATACA,6272,7924,741,287,29759,14337,15422,1,2
CACATACACCGGAAGGGCACATACA,4544,4959,712,583,29757,16425,13332,1,2
CACATACACCGGAAGGGCACATACA,7520,6073,789,452,22875,21951,924,0,0
CACATACACCGGAAGGGCACATACA,8459,6597,575,656,20686,20436,250,0,0
CACATACACCGGAAGGGCACATACA,7145,7784,540,585,26431,14752,11679,1,1
CACATACACCGGAAGGGCACATACA,7255,7387,805,587,21046,12546,8500,1,1
CACATACACCGGAAGGGCACATACA,6786,4926,810,474,25445,21454,3991,0,0
CACATACACCGGAAGGGCACATACA,4770,4160,736,475,22446,16421,6025,0,1
CACATACACCGGAAGGGCACATACA,6016,4289,568,836,26064,20751,5313,0,0
